11111111111111111111
1P011000C0000C000001
100C0001000000010001
100C0000010000000001
1000C00000000C000001
11000000010000000011
10010000011000000001
1000C0C0001100C000E1
11111111111111111111