1111111111111111111111111111111111111111
1P011000C0000C000001100000000C00000C0001
100C0001000000010001100C0001000000010001
100C0000010000000001100C0001000000010001
1000C00000000C000001100C0001000000010001
11000000010000000011100C0001C0000001C001
10010000011000000000100C0001000000010001
1000C0C0001100C000C0000C0001000000010001
11111111100111111100100C0001000000010001
11111111100111111100100C0001000C0001C001
1C0000000000000000E100C00001C00000C100C1
1111111111111111111111111111111111111111